1111111111111
1001000000001
1000011111101
1P0000E0000C1
1111111111111