111111111111111111111111111111
1E000000C000000000000000000001
100P11100C00000000000000000001
100000001000000000111000000001
100000001000000000000100000001
100000001000000000000000000001
100000001000000000000000000001
10000000100000000E000C00000001
10000000100000000C000000000001
100000001000111100000000C00001
100000001000000001000000000001
10000000100000E000000000000001
1000000010000000000C0000000001
100000001000000000000000000001
100000001000000000000000000001
100000001000000000000000000001
111111111111111111111111111111