111111111111111111111111111111
1E0C000CCCCCCCCCCC000000000001
100P11100000000000000000000001
100000001000000000111000000001
10000000100000000000C100000001
100000001000000000000000000001
100000001000000000000000000001
100000001000000000000000000001
100000001000000000000000000001
100000001000000000000000000001
100000001000000000000000000001
100000001000000000000000000001
100000001000000000000000000001
100000001000000000000000000001
100000001000000000000000000001
100000001000000000000000000001
111111111111111111111111111111