111111111
1PEC00001
100000001
111111111