111111111111111111111111111111
10EC00000000000000000000000001
1000111000000000000000000000P1
100000001000000000000000000001
100000001000000000000000000001
100000001000000000000000000001
100000001000000000000000000001
100000001000000000000000000001
100000001000000000000000000001
100000001000000000000000000001
100000001000000000000000000001
100000001000000000000000000001
100000001000000000000000000001
100000001000000000000000000001
100000001000000000000000000001
100000001000000000000000000001
111111111111111111111111111111