111111111111111111111111111111
1E0000000000000000000000000001
100P11100000000000000000000001
100000001000C00000111000000001
100000001000000000000100000001
100000C01000000000000000000001
100000001000000000000000000001
10000000100000000E000000000001
10000000100C000000000000000001
100000001000111100000000000001
100000001C00000001000000000001
10000000100000E000000000000001
100000001000000000000000000001
100000001000000000000000000001
100000001000000000000000000001
100000001000000000000000000001
111111111111111111111111111111