111111111111111111111111111111
10EC00000000000000000000000001
100011100000000000000000000001
10P000001000000000000000000001
111111111111111111111111111111